1111111111111111111111111111
100000000CCCC000000000000001
1C00011111111111100000000001
1110100000C00000011C00000001
100C00000111000000011C000001
1001111110000000000001100001
10000000C00011110000000110E1
1000C00111110000000C00000111
1011110000100001111111000001
10000000000C0000000000000001
1000000001111110000000000001
1P0000C0000000000000S0000001
1111111111111111111111111111
